1 1 1 1 1 1 1 1 1 1 1 1 1 1 1 1 1 1 1 1
1 0 0 0 0 0 0 0 0 0 0 0 0 0 0 3 0 0 8 1
1 0 1 1 1 1 1 1 1 1 1 1 1 1 1 0 1 1 9 1 
1 0 1 0 0 0 0 0 0 0 0 0 0 0 0 0 0 0 0 1
1 0 1 0 1 1 1 1 1 1 1 1 1 0 1 1 0 1 0 1
1 0 1 0 1 0 0 0 0 0 0 0 1 0 1 1 0 1 0 1
1 0 1 0 1 0 1 1 1 1 1 0 1 0 1 1 0 1 0 1
1 0 1 0 1 0 1 0 0 0 1 0 1 0 1 1 0 1 0 1
1 0 1 0 1 0 1 0 1 0 1 0 1 0 1 1 0 1 0 1
1 0 1 0 1 0 1 0 1 0 1 0 1 0 1 1 0 1 0 1
1 0 1 0 1 0 1 0 1 0 1 0 1 0 1 1 0 1 0 1
1 0 1 0 1 0 1 0 1 0 1 0 1 0 1 1 0 1 0 1
1 0 1 0 1 0 1 0 1 0 1 0 1 0 1 1 0 1 0 1
1 0 1 0 1 0 1 0 1 0 1 0 1 0 1 1 0 1 0 1
1 0 1 0 1 0 1 0 1 0 1 0 1 0 1 1 0 1 0 1
1 0 1 0 1 0 1 0 1 0 1 0 1 0 1 1 0 1 0 1
1 0 1 0 1 0 1 0 1 0 1 0 1 0 1 1 0 1 0 1
1 0 1 0 1 0 1 0 1 0 1 0 1 0 1 1 0 1 0 1
1 0 0 0 0 0 0 0 0 0 0 0 0 0 0 0 0 0 0 1
1 1 1 1 1 1 1 1 1 1 1 1 1 1 1 1 1 1 1 1